11111111111111
10010C000C0011
10100000000001
1C0010000C0011
100000000C0111
1000CP10000001
10010C00010001
1E0000010000C1
11111111111111