1111111
1001011
1010001
1C00101
1000001
1000CP1
1E10001
1C10001
1111111